R 800 600
NO ./textures/bluestone.xpm
SO ./textures/colorstone.xpm
WE ./textures/redbrick.xpm
EA ./textures/wood.xpm
S ./textures/barrel.xpm
F 5,100,0
C 220,30,0

        1111111111111111111111111
        1000000000110002000000001
        1100000111002000000000111
        1001000000000000002222201
11111111011000001110E000000000011
10000000001100000111000111111111
11110111111111011100000010001
11110111111111011101010010001
11000000100001011100000010001
10000000000000001100000010001
10000000000000001101010010001
1100000111010101111101111000111
11110111 1110101 101111010001
11111111 1111111 111111111111
